###############
#Hoo bHoHHHbbb#
#*oo@  o  oo  #
#  oooooooo   #
#H           b#
#            b#
#############o#
#AAAA       R #
#######B#######
#  *       *  #
# *2*  *  *2* #
#  *  *2*  *  #
#bb    *      #
#Rb    x      #
###############
