###############
#      @      #
#    b   b    #
# #         ###
# #    b   h#a#
# #h   b    #*#
# #    b   h#a#
#o#h   b    #o#
#a#    b   h#o#
###h   b    # #
#             #
#           b #
#######o#######
#1     x     *#
###############
